1111111111111
1001C000C00C1
10C0011111C01
1P0C11EC0C001
1111111111111
