111111111111111
1E0C0000C0000C1
10000C00000C101
1C1111111110101
101C00C00C10101
10101111101C101
10101C0010101C1
101C101P1C10101
1C101011101C101
10101C000C10101
101011111110101
101C00C00C0C1C1
101111111111111
1C000C00C000CE1
111111111111111
