1111111111111111111111111111111111111111111111111111111111111111111111111111111
1001C000000C0000000000000000000000000000000000000000000000000000000000000000001
10010000000C0000000000000000000000000000000000000000000000000000000000000000001
10010000000C0000000000000000000000000000000000000000000000000000000000000000001
10C10000000C0000000000000000000000000000000000000000000000000000000000000000001
10010000000C0000000000000000000000000000000000000000000000000000000000000000001
10C10000000C0000000000000000000000000000000000000000000000000000000000000000001
10010000000C0000000000000000000000000000000000000000000000000000000000000000001
100100C0000C0000000000000000000000000000000000000000000000000000000000000000001
10010000000C0000000000000000000000000000000000000000000000000000000000000000001
1000C11111000000000000000000000000000000000000000000000000000000000000000000001
1000C11111000000000000000000000000000000000000000000000000000000000000000000001
10C10000000C0000000000000000000000000000000000000000000000000000000000000000001
10010000000C0000000000000000000000000000000000000000000000000000000000000000001
100100C0000C0000000000000000000000000000000000000000000000000000000000000000001
10010000000C0000000000000000000000000000000000000000000000000000000000000000001
1000C11111000000000000000000000000000000000000000000000000000000000000000000001
1000C11111000000000000000000000000000000000000000000000000000000000000000000001
100CC11111000000000000000000000000000000000000000000000000000000000000000000001
100C011111000000000000000000000000000000000000000000000000000000000000000000001
10CC011111000000000000000000000000000000000000000000000000000000000000000000001
10C0011111000000000000000000000000000000000000000000000000000000000000000000001
10C0011111000000000000000000000000000000000000000000000000000000000000000000001
100C011111000000000000000000000000000000000000000000000000000000000000000000001
10010000000C0000000000000000000000000000000000000000000000000000000000000000001
10C10000000C0000000000000000000000000000000000000000000000000000000000000000001
10010000000C0000000000000000000000000000000000000000000000000000000000000000001
100100C0000C0000000000000000000000000000000000000000000000000000000000000000001
10010000000C0000000000000000000000000000000000000000000000000000000000000000001
1000C11111000000000000000000000000000000000000000000000000000000000000000000001
1000C11111000000000000000000000000000000000000000000000000000000000000000000001
10C10000000C0000000000000000000000000000000000000000000000000000000000000000001
10010000000C0000000000000000000000000000000000000000000000000000000000000000001
100100C0000C0000000000000000000000000000000000000000000000000000000000000000001
10010000000C0000000000000000000000000000000000000000000000000000000000000000001
1000C11111000000000000000000000000000000000000000000000000000000000000000000001
1000C11111000000000000000000000000000000000000000000000000000000000000000000001
100CC11111000000000000000000000000000000000000000000000000000000000000000000001
100C011111000000000000000000000000000000000000000000000000000000000000000000001
10CC011111000000000000000000000000000000000000000000000000000000000000000000001
10C0011111000000000000000000000000000000000000000000000000000000000000000000001
10C0011111000000000000000000000000000000000000000000000000000000000000000000001
100C011111000000000000000000000000000000000000000000000000000000000000000000001
10010000000C0000000000000000000000000000000000000000000000000000000000000000001
10C10000000C0000000000000000000000000000000000000000000000000000000000000000001
10010000000C0000000000000000000000000000000000000000000000000000000000000000001
100100C0000C0000000000000000000000000000000000000000000000000000000000000000001
10010000000C0000000000000000000000000000000000000000000000000000000000000000001
1000C11111000000000000000000000000000000000000000000000000000000000000000000001
1000C11111000000000000000000000000000000000000000000000000000000000000000000001
10C10000000C0000000000000000000000000000000000000000000000000000000000000000001
10010000000C0000000000000000000000000000000000000000000000000000000000000000001
100100C0000C0000000000000000000000000000000000000000000000000000000000000000001
10010000000C0000000000000000000000000000000000000000000000000000000000000000001
1000C11111000000000000000000000000000000000000000000000000000000000000000000001
1000C11111000000000000000000000000000000000000000000000000000000000000000000001
100CC11111000000000000000000000000000000000000000000000000000000000000000000001
100C011111000000000000000000000000000000000000000000000000000000000000000000001
10CC011111000000000000000000000000000000000000000000000000000000000000000000001
10C0011111000000000000000000000000000000000000000000000000000000000000000000001
10C0011111000000000000000000000000000000000000000000000000000000000000000000001
100C011111000000000000000000000000000000000000000000000000000000000000000000001
10010000000C0000000000000000000000000000000000000000000000000000000000000000001
10C10000000C0000000000000000000000000000000000000000000000000000000000000000001
10010000000C0000000000000000000000000000000000000000000000000000000000000000001
100100C0000C0000000000000000000000000000000000000000000000000000000000000000001
10010000000C0000000000000000000000000000000000000000000000000000000000000000001
1000C11111000000000000000000000000000000000000000000000000000000000000000000001
1000C11111000000000000000000000000000000000000000000000000000000000000000000001
10C10000000C0000000000000000000000000000000000000000000000000000000000000000001
10010000000C0000000000000000000000000000000000000000000000000000000000000000001
100100C0000C0000000000000000000000000000000000000000000000000000000000000000001
10010000000C0000000000000000000000000000000000000000000000000000000000000000001
1000C11111000000000000000000000000000000000000000000000000000000000000000000001
1000C11111000000000000000000000000000000000000000000000000000000000000000000001
100CC11111000000000000000000000000000000000000000000000000000000000000000000001
100C011111000000000000000000000000000000000000000000000000000000000000000000001
10CC011111000000000000000000000000000000000000000000000000000000000000000000001
10C0011111000000000000000000000000000000000000000000000000000000000000000000001
10C0011111000000000000000000000000000000000000000000000000000000000000000000001
100C011111000000000000000000000000000000000000000000000000000000000000000000001
10010000000C0000000000000000000000000000000000000000000000000000000000000000001
10C10000000C0000000000000000000000000000000000000000000000000000000000000000001
10010000000C0000000000000000000000000000000000000000000000000000000000000000001
100100C0000C0000000000000000000000000000000000000000000000000000000000000000001
10010000000C0000000000000000000000000000000000000000000000000000000000000000001
1000C11111000000000000000000000000000000000000000000000000000000000000000000001
1000C11111000000000000000000000000000000000000000000000000000000000000000000001
10C10000000C0000000000000000000000000000000000000000000000000000000000000000001
10010000000C0000000000000000000000000000000000000000000000000000000000000000001
100100C0000C0000000000000000000000000000000000000000000000000000000000000000001
10010000000C0000000000000000000000000000000000000000000000000000000000000000001
1000C11111000000000000000000000000000000000000000000000000000000000000000000001
1000C11111000000000000000000000000000000000000000000000000000000000000000000001
100CC11111000000000000000000000000000000000000000000000000000000000000000000001
100C011111000000000000000000000000000000000000000000000000000000000000000000001
10CC011111000000000000000000000000000000000000000000000000000000000000000000001
10C0011111000000000000000000000000000000000000000000000000000000000000000000001
10C0011111000000000000000000000000000000000000000000000000000000000000000000001
100C011111000000000000000000000000000000000000000000000000000000000000000000001
10010000000C0000000000000000000000000000000000000000000000000000000000000000001
10C10000000C0000000000000000000000000000000000000000000000000000000000000000001
10010000000C0000000000000000000000000000000000000000000000000000000000000000001
100100C0000C0000000000000000000000000000000000000000000000000000000000000000001
10010000000C0000000000000000000000000000000000000000000000000000000000000000001
1000C11111000000000000000000000000000000000000000000000000000000000000000000001
1000C11111000000000000000000000000000000000000000000000000000000000000000000001
10C10000000C0000000000000000000000000000000000000000000000000000000000000000001
10010000000C0000000000000000000000000000000000000000000000000000000000000000001
100100C0000C0000000000000000000000000000000000000000000000000000000000000000001
10010000000C0000000000000000000000000000000000000000000000000000000000000000001
1000C11111000000000000000000000000000000000000000000000000000000000000000000001
1000C11111000000000000000000000000000000000000000000000000000000000000000000001
100CC11111000000000000000000000000000000000000000000000000000000000000000000001
100C011111000000000000000000000000000000000000000000000000000000000000000000001
10CC011111000000000000000000000000000000000000000000000000000000000000000000001
10C0011111000000000000000000000000000000000000000000000000000000000000000000001
10C0011111000000000000000000000000000000000000000000000000000000000000000000001
100C011111000000000000000000000000000000000000000000000000000000000000000000001
10010000000C0000000000000000000000000000000000000000000000000000000000000000001
10C10000000C0000000000000000000000000000000000000000000000000000000000000000001
10010000000C0000000000000000000000000000000000000000000000000000000000000000001
100100C0000C0000000000000000000000000000000000000000000000000000000000000000001
10010000000C0000000000000000000000000000000000000000000000000000000000000000001
1000C11111000000000000000000000000000000000000000000000000000000000000000000001
1000C11111000000000000000000000000000000000000000000000000000000000000000000001
10C10000000C0000000000000000000000000000000000000000000000000000000000000000001
10010000000C0000000000000000000000000000000000000000000000000000000000000000001
100100C0000C0000000000000000000000000000000000000000000000000000000000000000001
10010000000C0000000000000000000000000000000000000000000000000000000000000000001
1000C11111000000000000000000000000000000000000000000000000000000000000000000001
1000C11111000000000000000000000000000000000000000000000000000000000000000000001
100CC11111000000000000000000000000000000000000000000000000000000000000000000001
100C011111000000000000000000000000000000000000000000000000000000000000000000001
10CC011111000000000000000000000000000000000000000000000000000000000000000000001
10C0011111000000000000000000000000000000000000000000000000000000000000000000001
10C0011111000000000000000000000000000000000000000000000000000000000000000000001
100C011111000000000000000000000000000000000000000000000000000000000000000000001
10010000000C0000000000000000000000000000000000000000000000000000000000000000001
10C10000000C0000000000000000000000000000000000000000000000000000000000000000001
10010000000C0000000000000000000000000000000000000000000000000000000000000000001
100100C0000C0000000000000000000000000000000000000000000000000000000000000000001
10010000000C0000000000000000000000000000000000000000000000000000000000000000001
1000C11111000000000000000000000000000000000000000000000000000000000000000000001
1000C11111000000000000000000000000000000000000000000000000000000000000000000001
10C10000000C0000000000000000000000000000000000000000000000000000000000000000001
10010000000C0000000000000000000000000000000000000000000000000000000000000000001
100100C0000C0000000000000000000000000000000000000000000000000000000000000000001
10010000000C0000000000000000000000000000000000000000000000000000000000000000001
1000C11111000000000000000000000000000000000000000000000000000000000000000000001
1000C11111000000000000000000000000000000000000000000000000000000000000000000001
100CC11111000000000000000000000000000000000000000000000000000000000000000000001
100C011111000000000000000000000000000000000000000000000000000000000000000000001
10CC011111000000000000000000000000000000000000000000000000000000000000000000001
10C0011111000000000000000000000000000000000000000000000000000000000000000000001
10C0011111000000000000000000000000000000000000000000000000000000000000000000001
100C011111000000000000000000000000000000000000000000000000000000000000000000001
10010000000C0000000000000000000000000000000000000000000000000000000000000000001
10C10000000C0000000000000000000000000000000000000000000000000000000000000000001
10010000000C0000000000000000000000000000000000000000000000000000000000000000001
100100C0000C0000000000000000000000000000000000000000000000000000000000000000001
10010000000C0000000000000000000000000000000000000000000000000000000000000000001
1000C11111000000000000000000000000000000000000000000000000000000000000000000001
1000C11111000000000000000000000000000000000000000000000000000000000000000000001
10C10000000C0000000000000000000000000000000000000000000000000000000000000000001
10010000000C0000000000000000000000000000000000000000000000000000000000000000001
100100C0000C0000000000000000000000000000000000000000000000000000000000000000001
10010000000C0000000000000000000000000000000000000000000000000000000000000000001
1000C11111000000000000000000000000000000000000000000000000000000000000000000001
1000C11111000000000000000000000000000000000000000000000000000000000000000000001
100CC11111000000000000000000000000000000000000000000000000000000000000000000001
100C011111000000000000000000000000000000000000000000000000000000000000000000001
10CC011111000000000000000000000000000000000000000000000000000000000000000000001
10C0011111000000000000000000000000000000000000000000000000000000000000000000001
10C0011111000000000000000000000000000000000000000000000000000000000000000000001
100C011111000000000000000000000000000000000000000000000000000000000000000000001
10010000000C0000000000000000000000000000000000000000000000000000000000000000001
10C10000000C0000000000000000000000000000000000000000000000000000000000000000001
10010000000C0000000000000000000000000000000000000000000000000000000000000000001
100100C0000C0000000000000000000000000000000000000000000000000000000000000000001
10010000000C0000000000000000000000000000000000000000000000000000000000000000001
1000C11111000000000000000000000000000000000000000000000000000000000000000000001
1000C11111000000000000000000000000000000000000000000000000000000000000000000001
10C10000000C0000000000000000000000000000000000000000000000000000000000000000001
10010000000C0000000000000000000000000000000000000000000000000000000000000000001
100100C0000C0000000000000000000000000000000000000000000000000000000000000000001
10010000000C0000000000000000000000000000000000000000000000000000000000000000001
1000C11111000000000000000000000000000000000000000000000000000000000000000000001
1000C11111000000000000000000000000000000000000000000000000000000000000000000001
100CC11111000000000000000000000000000000000000000000000000000000000000000000001
100C011111000000000000000000000000000000000000000000000000000000000000000000001
10CC011111000000000000000000000000000000000000000000000000000000000000000000001
10C0011111000000000000000000000000000000000000000000000000000000000000000000001
10C0011111000000000000000000000000000000000000000000000000000000000000000000001
100C011111000000000000000000000000000000000000000000000000000000000000000000001
10010000000C0000000000000000000000000000000000000000000000000000000000000000001
10C10000000C0000000000000000000000000000000000000000000000000000000000000000001
10010000000C0000000000000000000000000000000000000000000000000000000000000000001
100100C0000C0000000000000000000000000000000000000000000000000000000000000000001
10010000000C0000000000000000000000000000000000000000000000000000000000000000001
1000C11111000000000000000000000000000000000000000000000000000000000000000000001
1000C11111000000000000000000000000000000000000000000000000000000000000000000001
10C10000000C0000000000000000000000000000000000000000000000000000000000000000001
10010000000C0000000000000000000000000000000000000000000000000000000000000000001
100100C0000C0000000000000000000000000000000000000000000000000000000000000000001
10010000000C0000000000000000000000000000000000000000000000000000000000000000001
1000C11111000000000000000000000000000000000000000000000000000000000000000000001
1000C11111000000000000000000000000000000000000000000000000000000000000000000001
100CC11111000000000000000000000000000000000000000000000000000000000000000000001
100C011111000000000000000000000000000000000000000000000000000000000000000000001
10CC011111000000000000000000000000000000000000000000000000000000000000000000001
10C0011111000000000000000000000000000000000000000000000000000000000000000000001
10C0011111000000000000000000000000000000000000000000000000000000000000000000001
100C011111000000000000000000000000000000000000000000000000000000000000000000001
10010000000C0000000000000000000000000000000000000000000000000000000000000000001
10C10000000C0000000000000000000000000000000000000000000000000000000000000000001
10010000000C0000000000000000000000000000000000000000000000000000000000000000001
100100C0000C0000000000000000000000000000000000000000000000000000000000000000001
10010000000C0000000000000000000000000000000000000000000000000000000000000000001
1000C11111000000000000000000000000000000000000000000000000000000000000000000001
1000C11111000000000000000000000000000000000000000000000000000000000000000000001
10C10000000C0000000000000000000000000000000000000000000000000000000000000000001
10010000000C0000000000000000000000000000000000000000000000000000000000000000001
100100C0000C0000000000000000000000000000000000000000000000000000000000000000001
10010000000C0000000000000000000000000000000000000000000000000000000000000000001
1000C11111000000000000000000000000000000000000000000000000000000000000000000001
1000C11111000000000000000000000000000000000000000000000000000000000000000000001
100CC11111000000000000000000000000000000000000000000000000000000000000000000001
100C011111000000000000000000000000000000000000000000000000000000000000000000001
10CC011111000000000000000000000000000000000000000000000000000000000000000000001
10C0011111000000000000000000000000000000000000000000000000000000000000000000001
10C0011111000000000000000000000000000000000000000000000000000000000000000000001
100C011111000000000000000000000000000000000000000000000000000000000000000000001
10010000000C0000000000000000000000000000000000000000000000000000000000000000001
100100C0000C0000000000000000000000000000000000000000000000000000000000000000001
10010000000C0000000000000000000000000000000000000000000000000000000000000000001
1000C11111000000000000000000000000000000000000000000000000000000000000000000001
1000C11111000000000000000000000000000000000000000000000000000000000000000000001
10C10000000C0000000000000000000000000000000000000000000000000000000000000000001
10010000000C0000000000000000000000000000000000000000000000000000000000000000001
100100C0000C0000000000000000000000000000000000000000000000000000000000000000001
10010000000C0000000000000000000000000000000000000000000000000000000000000000001
1000C11111000000000000000000000000000000000000000000000000000000000000000000001
1000C11111000000000000000000000000000000000000000000000000000000000000000000001
100CC11111000000000000000000000000000000000000000000000000000000000000000000001
100C011111000000000000000000000000000000000000000000000000000000000000000000001
10CC011111000000000000000000000000000000000000000000000000000000000000000000001
10C0011111000000000000000000000000000000000000000000000000000000000000000000001
10C0011111000000000000000000000000000000000000000000000000000000000000000000001
100C011111000000000000000000000000000000000000000000000000000000000000000000001
1000011111C00000000000000000000000000000000000000000000000000000000000000000001
1P0011E00C000000000000000000000000000000000000000000000000000000000000000000001
1111111111111111111111111111111111111111111111111111111111111111111111111111111
